auto=car
bank=couch
fiets=bicycle
deur=door
poep=poop
vuur=fire
stoel=chair
muis=mouse
kleur=color
computer=computer
programma=program
bestand=file
goed=good
dippen=dipping
windows=ramen
appel=apple
blok=block
steen=stone
wiel=wheel
bus=bus
fortnite=gay
hout=wood
plassen=peeing
scherm=screen
klok=clock
kast=closet
ventilator=fan
boek=book
economie=economy
wiskunde=math
natuurkunde=physics
slaan=smash
latengaan=pass
watercloset=toilet
leider=leader
god=god
eng=scary
groot=big
papier=papier
pen=pencil
weten=knowing
wetenschap=science
biologie=biology
scheikunde=chemistry
schieten=shooting
terrorist=terrorist
kip=chicken
koe=cow
schijt=shit
toets=test
kabel=cable
schoen=shoe
